Rk,Team,Dateâ–²,PTS,,Opp,Result,MP,FG,FGA,FG%,2P,2PA,2P%,3P,3PA,3P%,FT,FTA,FT%,PTS,FG,FGA,FG%,2P,2PA,2P%,3P,3PA,3P%,FT,FTA,FT%,PTS
1,BOS,2011-04-22,113,@,NYK,W 113-96,240,42,83,.506,28,59,.475,14,24,.583,15,17,.882,113,33,76,.434,24,56,.429,9,20,.450,21,28,.750,96
2,BOS,2011-04-24,101,@,NYK,W 101-89,240,40,81,.494,37,69,.536,3,12,.250,18,24,.750,101,30,88,.341,22,61,.361,8,27,.296,21,28,.750,89
3,BOS,2011-05-01,90,@,MIA,L 90-99,240,32,75,.427,20,51,.392,12,24,.500,14,18,.778,90,32,68,.471,23,49,.469,9,19,.474,26,32,.813,99
4,BOS,2011-05-03,91,@,MIA,L 91-102,240,34,79,.430,28,68,.412,6,11,.545,17,22,.773,91,34,75,.453,27,59,.458,7,16,.438,27,36,.750,102
5,BOS,2011-05-11,87,@,MIA,L 87-97,240,33,67,.493,26,52,.500,7,15,.467,14,20,.700,87,32,69,.464,25,50,.500,7,19,.368,26,38,.684,97
6,BOS,2012-04-29,74,@,ATL,L 74-83,240,32,82,.390,32,71,.451,0,11,.000,10,13,.769,74,31,76,.408,24,56,.429,7,20,.350,14,21,.667,83
7,BOS,2012-05-01,87,@,ATL,W 87-80,240,29,68,.426,26,54,.481,3,14,.214,26,31,.839,87,29,83,.349,23,61,.377,6,22,.273,16,20,.800,80
8,BOS,2012-05-08,86,@,ATL,L 86-87,240,34,77,.442,28,63,.444,6,14,.429,12,15,.800,86,34,73,.466,27,57,.474,7,16,.438,12,14,.857,87
9,BOS,2012-05-16,107,@,PHI,W 107-91,240,40,77,.519,35,66,.530,5,11,.455,22,28,.786,107,33,81,.407,25,66,.379,8,15,.533,17,22,.773,91
10,BOS,2012-05-18,83,@,PHI,L 83-92,240,30,71,.423,23,48,.479,7,23,.304,16,19,.842,83,31,82,.378,26,71,.366,5,11,.455,25,36,.694,92
11,BOS,2012-05-23,75,@,PHI,L 75-82,240,26,78,.333,23,64,.359,3,14,.214,20,23,.870,75,32,70,.457,31,61,.508,1,9,.111,17,28,.607,82
12,BOS,2012-05-28,79,@,MIA,L 79-93,240,32,81,.395,28,67,.418,4,14,.286,11,21,.524,79,36,72,.500,31,47,.660,5,25,.200,16,23,.696,93
13,BOS,2012-05-30,111,@,MIA,L 111-115 (OT),265,40,81,.494,35,65,.538,5,16,.313,26,29,.897,111,37,83,.446,27,57,.474,10,26,.385,31,47,.660,115
14,BOS,2012-06-05,94,@,MIA,W 94-90,240,33,81,.407,27,66,.409,6,15,.400,22,27,.815,94,32,82,.390,25,56,.446,7,26,.269,19,25,.760,90
15,BOS,2012-06-09,88,@,MIA,L 88-101,240,35,75,.467,29,56,.518,6,19,.316,12,15,.800,88,36,70,.514,27,44,.614,9,26,.346,20,27,.741,101
16,BOS,2013-04-20,78,@,NYK,L 78-85,240,27,65,.415,22,45,.489,5,20,.250,19,19,1.000,78,32,79,.405,23,54,.426,9,25,.360,12,15,.800,85
17,BOS,2013-04-23,71,@,NYK,L 71-87,240,26,70,.371,21,51,.412,5,19,.263,14,18,.778,71,32,76,.421,25,57,.439,7,19,.368,16,22,.727,87
18,BOS,2013-05-01,92,@,NYK,W 92-86,240,32,70,.457,21,48,.438,11,22,.500,17,17,1.000,92,32,81,.395,27,59,.458,5,22,.227,17,20,.850,86
19,BOS,2015-04-19,100,@,CLE,L 100-113,240,37,79,.468,29,57,.509,8,22,.364,18,22,.818,100,37,82,.451,24,51,.471,13,31,.419,26,33,.788,113
20,BOS,2015-04-21,91,@,CLE,L 91-99,240,33,85,.388,27,63,.429,6,22,.273,19,22,.864,91,34,76,.447,27,47,.574,7,29,.241,24,26,.923,99
21,BOS,2016-04-16,101,@,ATL,L 101-102,240,37,102,.363,26,67,.388,11,35,.314,16,19,.842,101,35,86,.407,30,60,.500,5,26,.192,27,35,.771,102
22,BOS,2016-04-19,72,@,ATL,L 72-89,240,28,88,.318,23,60,.383,5,28,.179,11,12,.917,72,32,82,.390,21,53,.396,11,29,.379,14,16,.875,89
23,BOS,2016-04-26,83,@,ATL,L 83-110,240,29,77,.377,22,48,.458,7,29,.241,18,25,.720,83,42,96,.438,28,61,.459,14,35,.400,12,16,.750,110
24,BOS,2017-04-21,104,@,CHI,W 104-87,240,41,86,.477,24,49,.490,17,37,.459,5,7,.714,104,33,84,.393,27,63,.429,6,21,.286,15,15,1.000,87
25,BOS,2017-04-23,104,@,CHI,W 104-95,240,38,82,.463,28,45,.622,10,37,.270,18,22,.818,104,32,76,.421,27,52,.519,5,24,.208,26,33,.788,95
26,BOS,2017-04-28,105,@,CHI,W 105-83,240,39,80,.488,23,41,.561,16,39,.410,11,18,.611,105,32,81,.395,28,62,.452,4,19,.211,15,17,.882,83
27,BOS,2017-05-04,89,@,WAS,L 89-116,240,27,77,.351,17,45,.378,10,32,.313,25,33,.758,89,43,92,.467,35,67,.522,8,25,.320,22,25,.880,116
28,BOS,2017-05-07,102,@,WAS,L 102-121,240,35,79,.443,21,48,.438,14,31,.452,18,24,.750,102,44,84,.524,35,63,.556,9,21,.429,24,27,.889,121
29,BOS,2017-05-12,91,@,WAS,L 91-92,240,32,79,.405,21,44,.477,11,35,.314,16,18,.889,91,37,86,.430,32,62,.516,5,24,.208,13,21,.619,92
30,BOS,2017-05-21,111,@,CLE,W 111-108,240,42,91,.462,24,51,.471,18,40,.450,9,12,.750,111,32,70,.457,16,31,.516,16,39,.410,28,36,.778,108
31,BOS,2017-05-23,99,@,CLE,L 99-112,240,35,79,.443,25,48,.521,10,31,.323,19,20,.950,99,44,74,.595,34,52,.654,10,22,.455,14,17,.824,112
32,BOS,2018-04-20,92,@,MIL,L 92-116,240,32,80,.400,24,56,.429,8,24,.333,20,28,.714,92,45,79,.570,29,46,.630,16,33,.485,10,15,.667,116
33,BOS,2018-04-22,102,@,MIL,L 102-104,240,36,87,.414,26,58,.448,10,29,.345,20,25,.800,102,38,73,.521,28,50,.560,10,23,.435,18,24,.750,104
34,BOS,2018-04-26,86,@,MIL,L 86-97,240,30,81,.370,20,45,.444,10,36,.278,16,19,.842,86,38,75,.507,30,49,.612,8,26,.308,13,21,.619,97
35,BOS,2018-05-05,101,@,PHI,W 101-98 (OT),265,41,91,.451,31,53,.585,10,38,.263,9,14,.643,101,38,97,.392,29,67,.433,9,30,.300,13,18,.722,98
36,BOS,2018-05-07,92,@,PHI,L 92-103,240,31,75,.413,20,43,.465,11,32,.344,19,26,.731,92,38,94,.404,31,68,.456,7,26,.269,20,26,.769,103
37,BOS,2018-05-19,86,@,CLE,L 86-116,240,29,74,.392,23,52,.442,6,22,.273,22,28,.786,86,37,76,.487,20,42,.476,17,34,.500,25,30,.833,116
38,BOS,2018-05-21,102,@,CLE,L 102-111,240,35,85,.412,26,57,.456,9,28,.321,23,30,.767,102,41,81,.506,33,58,.569,8,23,.348,21,29,.724,111
39,BOS,2018-05-25,99,@,CLE,L 99-109,240,38,74,.514,26,46,.565,12,28,.429,11,20,.550,99,41,87,.471,32,64,.500,9,23,.391,18,22,.818,109
40,BOS,2019-04-19,104,@,IND,W 104-96,240,38,81,.469,23,47,.489,15,34,.441,13,22,.591,104,34,81,.420,23,51,.451,11,30,.367,17,23,.739,96
41,BOS,2019-04-21,110,@,IND,W 110-106,240,36,78,.462,25,50,.500,11,28,.393,27,34,.794,110,36,88,.409,26,60,.433,10,28,.357,24,28,.857,106
42,BOS,2019-04-28,112,@,MIL,W 112-90,240,47,87,.540,34,56,.607,13,31,.419,5,8,.625,112,31,89,.348,18,50,.360,13,39,.333,15,24,.625,90
43,BOS,2019-04-30,102,@,MIL,L 102-123,240,34,86,.395,24,58,.414,10,28,.357,24,27,.889,102,39,88,.443,19,41,.463,20,47,.426,25,31,.806,123
44,BOS,2019-05-08,91,@,MIL,L 91-116,240,29,93,.312,22,54,.407,7,39,.179,26,34,.765,91,42,94,.447,27,47,.574,15,47,.319,17,22,.773,116
45,BOS,2020-08-21,102,@,PHI,W 102-94,240,36,87,.414,28,56,.500,8,31,.258,22,24,.917,102,28,95,.295,19,56,.339,9,39,.231,29,34,.853,94
46,BOS,2020-08-23,110,@,PHI,W 110-106,240,38,82,.463,26,47,.553,12,35,.343,22,29,.759,110,35,82,.427,26,48,.542,9,34,.265,27,34,.794,106
47,BOS,2020-08-30,112,@,TOR,W 112-94,240,39,83,.470,22,44,.500,17,39,.436,17,21,.810,112,31,84,.369,21,44,.477,10,40,.250,22,29,.759,94
48,BOS,2020-09-01,102,@,TOR,W 102-99,240,32,76,.421,17,38,.447,15,38,.395,23,25,.920,102,36,90,.400,25,50,.500,11,40,.275,16,19,.842,99
49,BOS,2020-09-07,111,@,TOR,W 111-89,240,38,77,.494,27,43,.628,11,34,.324,24,27,.889,111,33,85,.388,21,45,.467,12,40,.300,11,13,.846,89
50,BOS,2020-09-11,92,@,TOR,W 92-87,240,35,86,.407,26,48,.542,9,38,.237,13,23,.565,92,31,75,.413,23,47,.489,8,28,.286,17,19,.895,87
51,BOS,2020-09-19,117,@,MIA,W 117-106,240,41,85,.482,32,59,.542,9,26,.346,26,30,.867,117,33,85,.388,21,41,.512,12,44,.273,28,34,.824,106
52,BOS,2020-09-23,109,@,MIA,L 109-112,240,39,82,.476,25,42,.595,14,40,.350,17,21,.810,109,39,91,.429,29,54,.537,10,37,.270,24,27,.889,112
53,BOS,2020-09-27,113,@,MIA,L 113-125,240,43,99,.434,28,53,.528,15,46,.326,12,15,.800,113,45,80,.563,32,53,.604,13,27,.481,22,26,.846,125
54,BOS,2021-05-22,93,@,BRK,L 93-104,240,31,84,.369,20,54,.370,11,30,.367,20,26,.769,93,35,84,.417,27,50,.540,8,34,.235,26,29,.897,104
55,BOS,2021-05-25,108,@,BRK,L 108-130,240,39,92,.424,27,58,.466,12,34,.353,18,23,.783,108,46,88,.523,29,50,.580,17,38,.447,21,22,.955,130
56,BOS,2021-06-01,109,@,BRK,L 109-123,240,40,92,.435,29,52,.558,11,40,.275,18,23,.783,109,43,84,.512,28,52,.538,15,32,.469,22,25,.880,123
57,BOS,2022-04-23,109,@,BRK,W 109-103,240,42,84,.500,30,45,.667,12,39,.308,13,14,.929,109,39,77,.506,27,48,.563,12,29,.414,13,16,.813,103
58,BOS,2022-04-25,116,@,BRK,W 116-112,240,42,89,.472,28,54,.519,14,35,.400,18,22,.818,116,41,81,.506,28,46,.609,13,35,.371,17,29,.586,112
59,BOS,2022-05-07,101,@,MIL,L 101-103,240,32,87,.368,23,54,.426,9,33,.273,28,34,.824,101,40,99,.404,31,65,.477,9,34,.265,14,17,.824,103
60,BOS,2022-05-09,116,@,MIL,W 116-108,240,42,84,.500,28,47,.596,14,37,.378,18,20,.900,116,39,94,.415,30,67,.448,9,27,.333,21,27,.778,108
61,BOS,2022-05-13,108,@,MIL,W 108-95,240,38,87,.437,21,44,.477,17,43,.395,15,23,.652,108,36,88,.409,29,59,.492,7,29,.241,16,18,.889,95
62,BOS,2022-05-17,107,@,MIA,L 107-118,240,36,79,.456,25,45,.556,11,34,.324,24,32,.750,107,39,80,.488,29,50,.580,10,30,.333,30,34,.882,118
63,BOS,2022-05-19,127,@,MIA,W 127-102,240,43,84,.512,23,44,.523,20,40,.500,21,23,.913,127,38,86,.442,28,52,.538,10,34,.294,16,22,.727,102
64,BOS,2022-05-25,93,@,MIA,W 93-80,240,33,71,.465,23,38,.605,10,33,.303,17,23,.739,93,30,94,.319,23,49,.469,7,45,.156,13,14,.929,80
65,BOS,2022-05-29,100,@,MIA,W 100-96,240,35,85,.412,24,53,.453,11,32,.344,19,24,.792,100,37,88,.420,31,58,.534,6,30,.200,16,24,.667,96
66,BOS,2022-06-02,120,@,GSW,W 120-108,240,43,85,.506,22,44,.500,21,41,.512,13,16,.813,120,39,88,.443,20,43,.465,19,45,.422,11,15,.733,108
67,BOS,2022-06-05,88,@,GSW,L 88-107,240,30,80,.375,15,43,.349,15,37,.405,13,17,.765,88,39,86,.453,24,49,.490,15,37,.405,14,20,.700,107
68,BOS,2022-06-13,94,@,GSW,L 94-104,240,31,75,.413,20,43,.465,11,32,.344,21,31,.677,94,41,88,.466,32,48,.667,9,40,.225,13,15,.867,104
69,BOS,2023-04-21,122,@,ATL,L 122-130,240,45,92,.489,24,44,.545,21,48,.438,11,16,.688,122,51,91,.560,36,57,.632,15,34,.441,13,16,.813,130
70,BOS,2023-04-23,129,@,ATL,W 129-121,240,46,89,.517,30,49,.612,16,40,.400,21,25,.840,129,43,98,.439,29,61,.475,14,37,.378,21,24,.875,121
71,BOS,2023-04-27,128,@,ATL,W 128-120,240,47,94,.500,29,52,.558,18,42,.429,16,17,.941,128,44,94,.468,29,59,.492,15,35,.429,17,22,.773,120
72,BOS,2023-05-05,114,@,PHI,W 114-102,240,38,86,.442,22,41,.537,16,45,.356,22,23,.957,114,31,78,.397,15,41,.366,16,37,.432,24,27,.889,102
73,BOS,2023-05-07,115,@,PHI,L 115-116 (OT),265,41,87,.471,24,43,.558,17,44,.386,16,22,.727,115,42,91,.462,29,57,.509,13,34,.382,19,22,.864,116
74,BOS,2023-05-11,95,@,PHI,W 95-86,240,33,78,.423,18,43,.419,15,35,.429,14,16,.875,95,30,83,.361,22,49,.449,8,34,.235,18,19,.947,86
75,BOS,2023-05-21,102,@,MIA,L 102-128,240,39,98,.398,28,56,.500,11,42,.262,13,17,.765,102,46,81,.568,27,46,.587,19,35,.543,17,21,.810,128
76,BOS,2023-05-23,116,@,MIA,W 116-99,240,43,84,.512,25,39,.641,18,45,.400,12,18,.667,116,34,78,.436,26,46,.565,8,32,.250,23,28,.821,99
77,BOS,2023-05-27,104,@,MIA,W 104-103,240,34,78,.436,27,43,.628,7,35,.200,29,34,.853,104,33,93,.355,19,63,.302,14,30,.467,23,29,.793,103
78,BOS,2024-04-27,104,@,MIA,W 104-84,240,39,82,.476,28,45,.622,11,37,.297,15,21,.714,104,32,77,.416,23,49,.469,9,28,.321,11,14,.786,84
79,BOS,2024-04-29,102,@,MIA,W 102-88,240,36,86,.419,22,49,.449,14,37,.378,16,18,.889,102,35,86,.407,26,53,.491,9,33,.273,9,12,.750,88
80,BOS,2024-05-11,106,@,CLE,W 106-93,240,41,80,.513,28,46,.609,13,34,.382,11,14,.786,106,36,84,.429,24,48,.500,12,36,.333,9,10,.900,93
81,BOS,2024-05-13,109,@,CLE,W 109-102,240,38,78,.487,26,46,.565,12,32,.375,21,24,.875,109,41,94,.436,26,46,.565,15,48,.313,5,7,.714,102