Rk,Team,Dateâ–²,PTS,,Opp,Result,MP,FG,FGA,FG%,2P,2PA,2P%,3P,3PA,3P%,FT,FTA,FT%,PTS,FG,FGA,FG%,2P,2PA,2P%,3P,3PA,3P%,FT,FTA,FT%,PTS
1,LAL,2011-04-22,100,@,NOH,W 100-86,240,37,76,.487,30,60,.500,7,16,.438,19,24,.792,100,33,72,.458,31,59,.525,2,13,.154,18,24,.750,86
2,LAL,2011-04-24,88,@,NOH,L 88-93,240,31,72,.431,27,54,.500,4,18,.222,22,30,.733,88,33,74,.446,29,60,.483,4,14,.286,23,27,.852,93
3,LAL,2011-04-28,98,@,NOH,W 98-80,240,34,74,.459,29,60,.483,5,14,.357,25,26,.962,98,30,70,.429,27,56,.482,3,14,.214,17,18,.944,80
4,LAL,2011-05-06,92,@,DAL,L 92-98,240,39,82,.476,36,69,.522,3,13,.231,11,14,.786,92,31,67,.463,19,38,.500,12,29,.414,24,29,.828,98
5,LAL,2011-05-08,86,@,DAL,L 86-122,240,31,82,.378,26,58,.448,5,24,.208,19,26,.731,86,44,73,.603,24,41,.585,20,32,.625,14,19,.737,122
6,LAL,2012-05-04,84,@,DEN,L 84-99,240,29,78,.372,23,53,.434,6,25,.240,20,25,.800,84,37,93,.398,31,77,.403,6,16,.375,19,23,.826,99
7,LAL,2012-05-06,92,@,DEN,W 92-88,240,39,86,.453,34,69,.493,5,17,.294,9,18,.500,92,39,86,.453,36,67,.537,3,19,.158,7,12,.583,88
8,LAL,2012-05-10,96,@,DEN,L 96-113,240,35,83,.422,31,69,.449,4,14,.286,22,30,.733,96,47,91,.516,37,71,.521,10,20,.500,9,17,.529,113
9,LAL,2012-05-14,90,@,OKC,L 90-119,240,35,81,.432,28,65,.431,7,16,.438,13,15,.867,90,44,83,.530,37,66,.561,7,17,.412,24,29,.828,119
10,LAL,2012-05-16,75,@,OKC,L 75-77,240,30,78,.385,28,63,.444,2,15,.133,13,14,.929,75,29,69,.420,23,52,.442,6,17,.353,13,16,.813,77
11,LAL,2012-05-21,90,@,OKC,L 90-106,240,34,75,.453,32,64,.500,2,11,.182,20,26,.769,90,42,90,.467,39,77,.506,3,13,.231,19,25,.760,106
12,LAL,2013-04-21,79,@,SAS,L 79-91,240,30,73,.411,27,58,.466,3,15,.200,16,24,.667,79,32,85,.376,25,63,.397,7,22,.318,20,25,.800,91
13,LAL,2013-04-24,91,@,SAS,L 91-102,240,37,82,.451,29,60,.483,8,22,.364,9,13,.692,91,42,82,.512,35,68,.515,7,14,.500,11,14,.786,102
14,LAL,2020-08-22,116,@,POR,W 116-108,240,39,78,.500,29,48,.604,10,30,.333,28,43,.651,116,39,95,.411,27,60,.450,12,35,.343,18,19,.947,108
15,LAL,2020-08-24,135,@,POR,W 135-115,240,49,87,.563,32,48,.667,17,39,.436,20,30,.667,135,40,89,.449,28,61,.459,12,28,.429,23,31,.742,115
16,LAL,2020-09-08,112,@,HOU,W 112-102,240,43,78,.551,33,48,.688,10,30,.333,16,23,.696,112,38,81,.469,26,51,.510,12,30,.400,14,14,1.000,102
17,LAL,2020-09-10,110,@,HOU,W 110-100,240,43,88,.489,34,58,.586,9,30,.300,15,16,.938,110,28,65,.431,14,32,.438,14,33,.424,30,39,.769,100
18,LAL,2020-09-22,106,@,DEN,L 106-114,240,43,83,.518,37,57,.649,6,26,.231,14,22,.636,106,40,73,.548,29,44,.659,11,29,.379,23,29,.793,114
19,LAL,2020-09-24,114,@,DEN,W 114-108,240,38,80,.475,28,50,.560,10,30,.333,28,35,.800,114,39,77,.506,29,49,.592,10,28,.357,20,23,.870,108
20,LAL,2020-10-04,104,@,MIA,L 104-115,240,34,79,.430,20,37,.541,14,42,.333,22,29,.759,104,41,80,.513,29,46,.630,12,34,.353,21,23,.913,115
21,LAL,2020-10-06,102,@,MIA,W 102-96,240,35,79,.443,21,40,.525,14,39,.359,18,21,.857,102,32,75,.427,21,43,.488,11,32,.344,21,26,.808,96
22,LAL,2020-10-11,106,@,MIA,W 106-93,240,43,89,.483,32,54,.593,11,35,.314,9,14,.643,106,35,79,.443,25,51,.490,10,28,.357,13,22,.591,93
23,LAL,2021-05-23,90,@,PHO,L 90-99,240,33,76,.434,26,50,.520,7,26,.269,17,28,.607,90,40,86,.465,31,58,.534,9,28,.321,10,12,.833,99
24,LAL,2021-05-25,109,@,PHO,W 109-102,240,36,80,.450,26,47,.553,10,33,.303,27,31,.871,109,33,71,.465,25,45,.556,8,26,.308,28,30,.933,102
25,LAL,2021-06-01,85,@,PHO,L 85-115,240,29,84,.345,17,49,.347,12,35,.343,15,21,.714,85,43,94,.457,29,52,.558,14,42,.333,15,21,.714,115
26,LAL,2023-04-16,128,@,MEM,W 128-112,240,49,92,.533,33,55,.600,16,37,.432,14,16,.875,128,42,89,.472,29,53,.547,13,36,.361,15,16,.938,112
27,LAL,2023-04-19,93,@,MEM,L 93-103,240,35,85,.412,28,59,.475,7,26,.269,16,21,.762,93,38,89,.427,27,53,.509,11,36,.306,16,21,.762,103
28,LAL,2023-04-26,99,@,MEM,L 99-116,240,37,92,.402,27,53,.509,10,39,.256,15,20,.750,99,44,99,.444,30,59,.508,14,40,.350,14,17,.824,116
29,LAL,2023-05-02,117,@,GSW,W 117-112,240,43,92,.467,37,67,.552,6,25,.240,25,29,.862,117,43,106,.406,22,53,.415,21,53,.396,5,6,.833,112
30,LAL,2023-05-04,100,@,GSW,L 100-127,240,40,94,.426,30,60,.500,10,34,.294,10,17,.588,100,48,95,.505,27,53,.509,21,42,.500,10,16,.625,127
31,LAL,2023-05-10,106,@,GSW,L 106-121,240,42,87,.483,32,60,.533,10,27,.370,12,15,.800,106,47,92,.511,34,57,.596,13,35,.371,14,15,.933,121
32,LAL,2023-05-16,126,@,DEN,L 126-132,240,46,84,.548,35,60,.583,11,24,.458,23,26,.885,126,50,91,.549,35,59,.593,15,32,.469,17,22,.773,132
33,LAL,2023-05-18,103,@,DEN,L 103-108,240,36,82,.439,28,52,.538,8,30,.267,23,26,.885,103,39,89,.438,25,51,.490,14,38,.368,16,18,.889,108
34,LAL,2024-04-20,103,@,DEN,L 103-114,240,39,79,.494,31,50,.620,8,29,.276,17,19,.895,103,47,102,.461,32,60,.533,15,42,.357,5,6,.833,114
35,LAL,2024-04-22,99,@,DEN,L 99-101,240,38,78,.487,25,48,.521,13,30,.433,10,13,.769,99,39,88,.443,31,54,.574,8,34,.235,15,17,.882,101
36,LAL,2024-04-29,106,@,DEN,L 106-108,240,39,84,.464,29,49,.592,10,35,.286,18,27,.667,106,42,89,.472,26,51,.510,16,38,.421,8,9,.889,108
